000011001110000
020001100222000
001000220000011
000000200001000
110002000000011
121100011110000
000000000000000
